8
Maple Grove Harbour
0
0,33,37,65,6 0,34,37,66,6 0,35,37,68,6e
1,34
6
-1,-1,8,0,1e
e
12,34,0,0,1e
Sound/final_area_theme.wav
e
WWWWWWWWWWWWWWWWWWWWWWWWWWWWWWWWW???WWWWWWWWWWWWWWWWWWWWWWWWWWWWWWWWW
LLLLWWLLLLLLLLLLLLLLLLLLLLLLLLLLLgggLLLLLLLLLLLLLLLLLLLLLLLLLLLWWLLLL
LLLLLWWLLLLLLLLLLLLLLLLWLLLLWWLWWgggWWLWWLLLLWLLLLLLLLLLLLLLLLWWLLLLL
LLLLLLWLLLLLLLLLWWWLLLWWWLLLWWWWWgggWWWWWLLLWWWLLLWWWLLLLLLLLLWLLLLLL
LLLLLLWLLLLLLLLWWWWWLLWWWWLWWWWWWgggWWWWWWLWWWWLLWWWWWLLLLLLLLWLLLLLL
LLLLLWWLLLLLLLLWWWWWWLWWWWWWWWWWWgggWWWWWWWWWWWLWWWWWWLLLLLLLLWWLLLLL
LLLLLWWLLLLLLLLWWWWWWWWWWWWWWWWWWgggWWWWWWWWWWWWWWWWWWLLLLLLLLWWLLLLL
LLLLLWWWLLLLLLLLWWWWWWWWWWWWWWWWWgggWWWWWWWWWWWWWWWWWLLLLLLLLWWWLLLLL
LLLLLWWWWWLLLLLLLWWWWWWWWWWWWWWWgggggWWWWWWWWWWWWWWWLLLLLLLWWWWWLLLLL
LLWLWWWWWWWWLLLLLLWWWWWWWWWWWWWWgggggWWWWWWWWWWWWWWLLLLLLWWWWWWWWLWLL
LLWWWWWWWWWWWWLLLLLWWWWWWWWWWWgggggggggWWWWWWWWWWWLLLLLWWWWWWWWWWWWLL
LLWWWWWWWWWWWWWWLLLLWWWWWWWWWWg       gWWWWWWWWWWLLLLWWWWWWWWWWWWWWLL
LLWWWWWWWWWWWWWWWWLLLWWWWWWWWWg   !   gWWWWWWWWWLLLWWWWWWWWWWWWWWWWLL
LLWWWWWWWWWWWWWWWWWWLLWWWWWWWWg       gWWWWWWWWLLWWWWWWWWWWWWWWWWWWLL
LLWWWWWWWWWWWWWWWWWWWWWWWWWWWWgggggggggWWWWWWWWWWWWWWWWWWWWWWWWWWWWLL
LLWWWWWWWWWWWWWWWWWWWWWWWWWWWWWWWWWWWWWWWWWWWWWWWWWWWWWWWWWWWWWWWWWLL
LLWWWLWWWWWWWWWWWWWWWWWWWWWWWWWWWWWWWWWWWWWWWWWWWWWWWWWWWWWWWWWLWWWLL
LLWWLLLLWWWWWWWWWWWWWWWWWWWWWWWWWWWWWWWWWWWWWWWWWWWWWWWWWWWWWLLLLWWLL
LLWWLLLLWWWWLWWWWWWWWWWWWWWWWWWWWWWWWWWWWWWWWWWWWWWWWWWWLWWWWLLLLWWLL
LLWLLLLWWWWLLWWWWWWLWWWWLWWWWWWWWWWWWWWWWWWWLWWWWLWWWWWWLLWWWWLLLLWLL
LLLLLLLWWWLLLLWWWWLLWWWLLWWWLWWWWWWWWWWWLWWWLLWWWLLWWWWLLLLWWWLLLLLLL
LLLLLLLWWLLLLLWWWLLLLWWLLWWLLWWWWWLWWWWWLLWWLLWWLLLLWWWLLLLLWWLLLLLLL
LLLLLLLWWLLLLLWWLLLLLWLLLWLLLLWLWLLLWLWLLLLWLLLWLLLLLWWLLLLLWWLLLLLLL
LLLLLLLWWLLLLLWWLLLLLWLLLWLLLLLLLLLLLLLLLLLWLLLWLLLLLWWLLLLLWWLLLLLLL
LLLLLLWWLLLLLLWWLLLLLWLLLLLLLLLLLLLLLLLLLLLLLLLWLLLLLWWLLLLLLWWLLLLLL
LLLLLLWWLLLLLLLWWLLLLLLLLLLLLLLLLLLLLLLLLLLLLLLLLLLLWWLLLLLLLWWLLLLLL
LLLLLLLWWLLLLLLLWLLLLLLLLLLLLLLLLLLLLLLLLLLLLLLLLLLLWLLLLLLLWWLLLLLLL
LLLLLLLLLWWLLLLLLLLLLLLLLLLLLLLLLLLLLLLLLLLLLLLLLLLLLLLLLLLWWLLLLLLLL
LLLLLLLLLLLLLLLLLLLLLLLLLLLLLLLLLLLLLLLLLLLLLLLLLLLLLLLLLLLLLLLLLLLLL