4
Abandoned Path F2
1
2,6,31,5,3 17,80,21,55,5e
3,6
6
e
19,5,0,6,6,6,1e
DDDDDDDDDDDDDDDDDDDDDDDDDDDDDDDDDDDDDDDDDDDDDDDDDDDDDDDDDDDDDDDDDDDDDDDDDDDDDDDDDDDDDDDDD
DDDdRRRRRRRRRRRRRRRRRRRRRRRRRRRRRRRRRRRRRRRRRRRRRRDDDDDDDDDDDDDDDDDDDDDDDDDDDDDDDDDDDDDDD
DDRRRR?RR                                     GGGRRDDDDDDDDDDDDDDDDDDDDDDDDDDDDDDDDDDDDDD
DDRR                  G                         GGRDDDDDDDDDDDDDDDDDDDDDDDDDDDDDDDDDDDDDD
DRRG                GG G                          RRDDDDDDDDDDDDDDDDDDDDDDDDDDDDDDDDDDDDD
DRRGG                GG                           RRDDDDDDDDDDDDDDDDDDDDDDDDDDDDDDDDDDDDD
DWWWGG                                   GG        RRDDDDDDDDDDDDDDDDDDDDDDDDDDDDDDDDDDDD
DWWWWWWWWWWWWWW              WWWWWWWWWWWWWW   WWW  RRDDDDDDDDDDDDDDDDDDDDDDDDDDDDDDDDDDDD
DRRWWWWWWWWWWWWWWWWWWWWWWWWWWWWWWWWWWWWWWWW   WWWWWWWDDDDDDDDDDDDDDDDDDDDDDDDDDDDDDDDDDDD
DRR           WWWWWWWWWWWWWWWW                  WWWWWDDDDDDDDDDDDDDDDDDDDDDDDDDDDDDDDDDDD
DRR G                   GG                      WWWRRDDDDDDDDDDDDDDDDDDDDDDDDDDDDDDDDDDDD
DRR  G                                          WWWRRDDDDDDDDDDDDDDDDDDDDDDDDDDDDDDDDDDDD
DRR                                             WWWRRDDDDDDDDDDDDDDDDDDDDDDDDDDDDDDDDDDDD
DRRRR            G                             GWWWRRDDDDDDDDDDDDDDDDDDDDDDDDDDDDDDDDDDDD
DDDRRRR        GGRRRRR      RR       GG      GGWWWWRRDDDDDDDDDDDDDDDDDDDDDDDDDDDDDDDDDDDD
DDDRRRRRRRRRRRRRRRRRRRRR   RRRRRR   GGGG  WWWWWWWRRRRDDDDDDDDDDDDDDDDDDDDDDDDDDDDDDDDDDDD
DDDRRRRRRRRRRRRRRRRRRRR     RRRRRRRRRRRRRRRRRRRRRRRRRDDDDDDDDDDDDDDDDDDDDRRRRRRRRRRRDDDDD
DRRRR GG  RRRRRRRRRR              RRRRRRRRRRRRRRRRRRRDDDDDDDDDDDDDDDDDDRRRRRRRRR?RRRRRDDD
DRR                                             GRRRDDDDDDDDDDDDDDDDDDRRGG         GGRRDD
DRR  =                 GGGGGG                    GRRRDDDDDDDDDDDDDDDRRRG             GWRR
DRRR                 GGRRRRRRG                      RRRRRRWWWRRRRRRRRR               WWRR
DDRRRRRR     GG   RRRRRRRRDDRRRRGG       RRRRR              WWW                    WWWWRR
DDDDDDDRRRRRRRRRRRDDDDDDDDDDDDRRRRRRRRRRRDDRRRRR                                  WWWWWRR
DDDDDDDDDDDDDDDDDDDDDDDDDDDDDDDDDDDDDDDDDDDDDDRRRR GG        WWWWWWWWWWWWW      WWWWWWWRR
DDDDDDDDDDDDDDDDDDDDDDDDDDDDDDDDDDDDDDDDDDDDDDDDRRRRRRRRRRRRRRRRWWWWRRRRWWWWWWWWWWWWRRRRD
DDDDDDDDDDDDDDDDDDDDDDDDDDDDDDDDDDDDDDDDDDDDDDDDDDDDDDDDDDDDDDDDDDDDDRRRRRWWWWWWWWRRRRDDD
DDDDDDDDDDDDDDDDDDDDDDDDDDDDDDDDDDDDDDDDDDDDDDDDDDDDDDDDDDDDDDDDDDDDDDDDRRRRRRRRRRRRDDDDD
DDDDDDDDDDDDDDDDDDDDDDDDDDDDDDDDDDDDDDDDDDDDDDDDDDDDDDDDDDDDDDDDDDDDDDDDDRRRRRRRRRRDDDDDD