8
Abandoned Path F2
0
21,56,18,79,4 27,52,6,125,6e
21,55
6
e
26,55,0,-1,-1,-1,1e
26,52,0,1,0e
Sound/cave_music.wav
WWWWWWWWWWWWWWWWWWWWWWWWWWWWWWWWWg?gWWWWWWWWWWWWWWWWWWWWWWWWWWWWWWWWW
RRRRWWRRRRRRRRRRRRRRRRRRRRRRRRRRRgggRRRRRRRRRRRRRRRRRRRRRRRRRRRWWRRRR
RRRRRWWRRRRRRRRRRRRRRRRWRRRRWWRWWgggWWRWWRRRRWRRRRRRRRRRRRRRRRWWRRRRR
RRRRRRWRRRRRRRRRWWWRRRWWWRRRWWWWWgggWWWWWRRRWWWRRRWWWRRRRRRRRRWRRRRRR
RRRRRRWRRRRRRRRWWWWWRRWWWWRWWWWWWgggWWWWWWRWWWWRRWWWWWRRRRRRRRWRRRRRR
RRRRRWWRRRRRRRRWWWWWWRWWWWWWWWWWWgggWWWWWWWWWWWRWWWWWWRRRRRRRRWWRRRRR
RRRRRWWRRRRRRRRWWWWWWWWWWWWWWWWWWgggWWWWWWWWWWWWWWWWWWRRRRRRRRWWRRRRR
RRRRRWWWRRRRRRRRWWWWWWWWWWWWWWWWWgggWWWWWWWWWWWWWWWWWRRRRRRRRWWWRRRRR
RRRRRWWWWWRRRRRRRWWWWWWWWWWWWWWWgggggWWWWWWWWWWWWWWWRRRRRRRWWWWWRRRRR
RRWRWWWWWWWWRRRRRRWWWWWWWWWWWWWWgggggWWWWWWWWWWWWWWRRRRRRWWWWWWWWRWRR
RRWWWWWWWWWWWWRRRRRWWWWWWWWWWWgggggggggWWWWWWWWWWWRRRRRWWWWWWWWWWWWRR
RRWWWWWWWWWWWWWWRRRRWWWWWWWWWWg       gWWWWWWWWWWRRRRWWWWWWWWWWWWWWRR
RRWWWWWWWWWWWWWWWWRRRWWWWWWWWWg   !   gWWWWWWWWWRRRWWWWWWWWWWWWWWWWRR
RRWWWWWWWWWWWWWWWWWWRRWWWWWWWWg       gWWWWWWWWRRWWWWWWWWWWWWWWWWWWRR
RRWWWWWWWWWWWWWWWWWWWWWWWWWWWWgggggggggWWWWWWWWWWWWWWWWWWWWWWWWWWWWRR
RRWWWWWWWWWWWWWWWWWWWWWWWWWWWWWWWWWWWWWWWWWWWWWWWWWWWWWWWWWWWWWWWWWRR
RRWWWRWWWWWWWWWWWWWWWWWWWWWWWWWWWWWWWWWWWWWWWWWWWWWWWWWWWWWWWWWRWWWRR
RRWWRRRRWWWWWWWWWWWWWWWWWWWWWWWWWWWWWWWWWWWWWWWWWWWWWWWWWWWWWRRRRWWRR
RRWWRRRRWWWWRWWWWWWWWWWWWWWWWWWWWWWWWWWWWWWWWWWWWWWWWWWWRWWWWRRRRWWRR
RRWRRRRWWWWRRWWWWWWRWWWWRWWWWWWWWWWWWWWWWWWWRWWWWRWWWWWWRRWWWWRRRRWRR
RRRRRRRWWWRRRRWWWWRRWWWRRWWWRWWWWWWWWWWWRWWWRRWWWRRWWWWRRRRWWWRRRRRRR
RRRRRRRWWRRRRRWWWRRRRWWRRWWRRWWWWWRWWWWWRRWWRRWWRRRRWWWRRRRRWWRRRRRRR
RRRRRRRWWRRRRRWWRRRRRWRRRWRRRRWRWRRRWRWRRRRWRRRWRRRRRWWRRRRRWWRRRRRRR
RRRRRRRWWRRRRRWWRRRRRWRRRWRRRRRRRRRRRRRRRRRWRRRWRRRRRWWRRRRRWWRRRRRRR
RRRRRRWWRRRRRRWWRRRRRWRRRRRRRRRRRRRRRRRRRRRRRRRWRRRRRWWRRRRRRWWRRRRRR
RRRRRRWWRRRRRRRWWRRRRRRRRRRRRRRRRRRRRRRRRRRRRRRRRRRRWWRRRRRRRWWRRRRRR
RRRRRRRWWRRRRRRRWRRRRRRRRRRRRRRRRRRRRRRRRRRRRRRRRRRRWRRRRRRRWWRRRRRRR
RRRRRRRRRWWRRRRRRRRRRRRRRRRRRRRRRRRRRRRRRRRRRRRRRRRRRRRRRRRWWRRRRRRRR
RRRRRRRRRRRRRRRRRRRRRRRRRRRRRRRRRRRRRRRRRRRRRRRRRRRRRRRRRRRRRRRRRRRRR